XXXXXXXXXXXXXXXXXXXXXXXXXXXX
X                          X
X XX  X    X  X  XXX   X   X
X fX  X    XXXX  XXXXXXX   X
X  X  X                    X
X     X    XXXXXXXXXXXXX   X
X     X    X               X
X     X    X               X
X                          X
XXXXXXXXXXXXXXXXXXXXXXXXXXXX