XXXXXXXXXXXXXXXXXXXXXX
X                X   X
X XX      XXXX    X  X
X  X      XXXX       X
X  X  f              X
XXXXXXXXXXXXXXXXXXXXXX